 3  0  0  0  0  0  0  0  0  0  0  0
 0  0  0  0 10 10 10  6  0  0  2  0
 0  2  0  0 11  2  2 11  0  0  0  0
 0  2  0  0 11  2  2 11  0  0  0  0
 0  0  0  0 11  2  2 11  0  0  0  0
 0  0  0  0 14 10 10 14 10 10 10 10
 0  0  0  0  0  0  0  0  0  0  0  1
 0  0  0  0  0  0  0  0  0  0  0  0
 0  0  0  0  0  0  0  0  0  0  0  4
10 10  6  0  0  1  0  0  0 15 12 12
 0  0 11  0  0  1  0  0  0 11  0  0
 0  0 11  2  0  1  0  0  0 11  0  0